1111111111111111111111
1P00YCCC0000CCC0000YX1
1111011011Y11110111001
111101111101101Y111001
11111111111110111111C1
10000C011110C01X0C0001
1000X1X0C000101C0000X1
1X00010000CX1Y1X0C0001
1000X1111111101C0000X1
10000000000E1XC0000001
1111111111111111111111
